11111111111111111
100000C10000000C1
10S100010000S0001
10011100011110001
1P000C1C0S1E00001
11111111111111111